B B B B B B B B
 *           *W
W r r r r r r  
              W
W r r r r r r  
              W
W r r r r r r  
              W
W r r r r r r  
              W
W r r r r r r  
 *           *W
B B B B B B B B